цууны	цуу @@ы
хөөс	хөөс
хөдөлгөх	хөдлөх @@гөх
ачлалыг	ач @@лах @@л @@ыг
үрчлээ	үрчл @@ээ
тайлангийн	тайлан @@ийн
савлуураар	сав @@лах @@уур @@аар
санхүүгээр	сан @@хүү @@ээр
бэлхүүсэвчийн	бэлхүүс @@вч @@ийн
соёлждог	соёл @@жих @@дог
савхийг	савхи @@ийг
ганхалт	ганхах @@лт
хэрүүлтэй	хэрүүл @@тэй
хавцлыг	хавцал @@ыг
солилцоогоор	солих @@лцох @@оо @@оор
солиог	солио @@г
зулайгаар	зулай @@аар
сунгах	сунах @@гах
дуульд	дууль @@д
галзуурах	галзуу @@рах
амталгааг	амтлах @@гаа @@г
ашиглалтаас	ашиг @@лах @@лт @@аас
хураангуй	хураах @@нгуй
авиагаар	авиа @@аар
тэвчээрт	тэвчих @@ээр @@т
чансааны	чансаа @@ы
сэдвийг	сэдэв @@ийг
оньс	оньс
үсрэлтэд	үсрэх @@лт @@д
оршихуй	орших @@уй
хувьсалтай	хувь @@сах @@л @@тай
тохуунаас	тохуу @@аас
хөтөлбөрт	хөтлөх @@бөр @@т
өмхий	өмхий
үхэх	үхэх
томыг	том @@ыг
өөдсийг	өөдөс @@ийг
тэмүүлэх	тэмүүлэх
консулаар	консул @@аар
гадилтай	гадил @@тай
аргаар	арга @@аар
өлсгөлөнг	өлсөг @@лөх @@нг
иогтой	иог @@той
далайцтай	далай @@тай
хандлагаа	хандалаг @@аа
дамчинд	дамчин @@д
барцдаас	барцад @@аас
оврыг	овор @@ыг
аймгаар	аймаг @@аар
онцлогийг	онц @@лог @@ийг
амьжиргаагаар	амьжих @@ргаа @@аар
алдартныг	алдарт @@ыг
сэжүүртэй	сэжүүр @@тэй
тэнгис	тэнгис
буудлагатай	буу @@дах @@лага @@тай
дайснаар	дайн @@саар
зараагаар	зараа @@аар
удирдлагатай	удирдах @@лага @@тай
зөөвөрлөх	зөөх @@вөр @@лөх
дагагчаар	дагах @@гч @@аар
зүхлээр	зүхэл @@ээр
нуураа	нуур @@аа
цагдаагаас	цагдаа @@аас
харьцаатай	харих @@цаа @@тай
шатнаас	шат @@аас
байгаа	бай @@аа
үнэг	үнэг
толгойгоо	толгой @@оо
гял	гял
өгөөшийг	өгөөш @@ийг
зарцтай	зарц @@тай
луйврыг	луйвар @@ыг
стратегийн	стратеги @@ийн
ичгүүр	ичих @@гүүр
судалгаа	судлах @@гаа
холгодсоо	холгодос @@оо
хугацааны	хугацаа @@ы
загасчлалаар	загас @@члах @@л @@аар
романаас	роман @@аас
хэрэглэгчид	хэрэглэх @@гч @@д
энэрлээ	энэрэх @@л @@ээ
нээлтийг	нээх @@лт @@ийг
өндгөө	өндөг @@өө
өтгөрөх	өтгөрөх
ширгээс	ширэг @@ээс
мангастай	мангас @@тай
сувдаа	сувд @@аа
довтлолт	довтлох @@лт
гарлаа	гарал @@аа
шавааралдуулах	шаваар @@лах @@лдах @@улах
туяанаас	туяа @@аас
гэлэнмаагаар	гэлэн @@маа @@аар
коллежоор	коллеж @@оор
хэрүүл	хэрүүл
сөнөөгчөөс	сөнөөх @@гч @@өөс
нийлэмжид	нийлэх @@мж @@д
үргүйдлийн	үр @@гүй @@дэл @@ийн
сүүнээс	сүү @@ээс
бараагаа	бараа @@аа
хоцрогдолд	хоцрох @@гдох @@л @@д
хуйвалдаан	хуйвалдах @@аан
гогцоонд	гогцоо @@д
аалзнаас	аалз @@аас
жодоо	жод @@оо
мөөгөнд	мөөг @@д
өтгөрүүлэх	өтгөрөх @@үүлэх
шилжилтийг	шилжих @@лт @@ийг
төвөөр	төв @@өөр
эмээл	эмээл
дагагчаа	дага @@гч @@аа
заагчид	заах @@гч @@д
эргүүгээр	эргэүү @@ээр
ёроолын	ёроол @@ын
бүрэлбаанд	бүрэлбаа @@д
санаачлагчаар	санаа @@члах @@гч @@аар
идеализмыг	идеализм @@ыг
нөмрөг	нөмрөг
ирвэгнэх	ирвэг @@нэх
ургацгийг	ургах @@ц @@г @@ийг
цогцолборт	цогцлох @@бор @@т
бүрээсний	бүрээс @@ий
цуглуулга	цуг @@луулах @@га
нийлбэрээр	нийлэх @@бэр @@ээр
исэлтээс	исэлт @@ээс
ууршилт	уур @@ших @@лт
адилсалтай	адил @@сах @@л @@тай
эргүүлэгтэй	эргэх @@үүлэг @@тэй
мэргэжилтнийг	мэргэжих @@лт @@ийг
хямдралаас	хямд @@рах @@л @@аас
хатуулга	хатуулах @@га
уралдаантай	уралдах @@аан @@тай
үүсэх	үүсэх
чуулгыг	чуулга @@ыг
сонсдог	сонс @@дог
адилтгах	адил @@тгах
хардалтын	хардах @@лт @@ын
ухуулах	ухах @@уулах
ихэсгэх	ихэсэг @@х
жараахайг	жараахай @@г
тэрслэгчээс	тэрс @@лэх @@гч @@ээс
дамаар	дам @@аар
тулаан	тулах @@аан
продакшны	продакшн @@ы
егөөдөлтэй	егөө @@дөх @@л @@тэй
компанийг	компан @@ийг
хамтатгалтай	хамт @@тгах @@л @@тай
алдаанаас	алдах @@аа @@аас
үүргэвчээр	үүрэг @@вч @@ээр
орцын	орц @@ын
хонийг	хонь @@ийг
давтлагаас	давтах @@лага @@аас
туяаны	туяа @@ы
угтах	угтах
хөдсийг	хөдөс @@ийг
оролцоогоор	орлох @@цоо @@оор
суудлаа	суух @@дал @@аа
урианаас	урих @@аас
бэхжилтээс	бэх @@жих @@лт @@ээс
гэрээгээр	гэрээ @@ээр
гайхамшгийг	гайхамшиг @@ийг
дуулгыг	дуу @@лаг @@ыг
найруулгаас	найрах @@уулах @@га @@аас
доргиогоо	доргио @@оо
хавтсаар	хавтс @@аар
аймаг	аймаг
дэнс	дэнс
үүсвэр	үүс @@вэр
харамсалд	харамсах @@л @@д
алхаагаа	алхаа @@аа
барзгар	барзгар
ачаагаар	ачиа @@аар
ятгалгад	ятгах @@лга @@д
гүйцэтгэлийн	гүйцэд @@гэх @@л @@ийн
цэцэрлэгжүүлэх	цэцэрлэг @@жих @@үүлэх
аргыг	арга @@ыг
найдах	найдах
хошингоос	хошин @@оос
шийдэд	шийд @@д
нүхэнд	нүх @@д
гуалингаар	гуалин @@аар
янз	янз
хоримогц	хоримогц
исэлтээ	исэлт @@ээ
лазераар	лазер @@аар
биллиардын	биллиард @@ын
хүрмээ	хүрэм @@ээ
нийлүүлэлтээс	нийлэх @@үүлэх @@лт @@ээс
эмнэлгээс	эмнэх @@лэг @@ээс
жорлонгоос	жорлон @@оос
лимбэдмээр	лимбэ @@дэм @@ээр
халамжийн	халамж @@ийн
будах	будах
атомын	атом @@ын
өнгөлөлгүй	өнгө @@лөх @@лгүй
байлдаан	байлдах @@аан
тосоор	тос @@оор
уянга	уянга
цөөрмөө	цөөрм @@өө
хориглолтоор	хорих @@глох @@лт @@оор
галууг	галуу @@г
довцгоо	довцг @@оо
зуучлагчаар	зууч @@лах @@гч @@аар
сургуулийг	сургах @@ууль @@ийг
ангиллаас	анги @@л @@аас
шөрмөсний	шөрмөс @@ий
сүлжих	сүлжих
сэтгүүлчийн	сэтгэх @@үүл @@ийн
философийг	философи @@ийг
зохиомжид	зохиох @@мж @@д
савхдангаа	савх @@дах @@нгаа
тэсвэрийг	тэсэх @@вэр @@ийг
урагшилцгаа	урагш @@лах @@цгаа
философиор	философи @@ор
хулмастай	хулмас @@тай
зөрөлдөөний	зөрөлдөх @@өөн @@ий
микробиологио	микро @@биологи @@о
трамвайтай	трамвай @@тай
галлалтад	гал @@лах @@лт @@д
ёжлолтой	ёж @@лох @@л @@той
төрийн	төр @@ийн
шилбэнд	шилбэ @@д
бясалгалтай	бясах @@лгах @@л @@тай
гэрлэлтийн	гэр @@лэх @@лт @@ийн
чидунд	чидун @@д
студиэ	студи @@э
майонезад	майонез @@д
ажиллазна	ажилалзан
гаргалттай	гаргах @@лт @@тай
үйлчилгээтэй	үйл @@члэх @@гээ @@тэй
олборлолтыг	олбор @@лох @@лт @@ыг
цавинд	цавь @@д
гацуурын	гацуур @@ын
хориг	хориг
гараа	гар @@аа
ферментээр	фермент @@ээр
тэсвэртэй	тэсэвэр @@тэй
түрээсийг	түрээс @@ийг
өрцнөөс	өрц @@өөс
хавраа	хавар @@аа
бэсрэгийг	бэсрэг @@ийг
чиргүүл	чирэх @@гүүл
холестерин	холестерин
төслийг	төсөл @@ийг
асфальт	асфальт
зангиагаар	зангиа @@аар
ёсгүй	ёс @@гүй
товчлолтой	товч @@лох @@л @@той
босуулаа	босох @@уул @@аа
цөмчөөсэй	цөмч @@өөсэй
баганаа	багана
бүртгэлээр	бүртгэх @@л @@ээр
фронтоо	фронт @@оо
дархлаагаар	дархлаа @@аар
боолтоо	боох @@лто
ламптай	ламп @@тай
тасалбарын	тас @@лах @@бар @@ын
бөглөө	бөглөө
бүтэлгүйтлээ	бүтэх @@лгүй @@тэл
хагарал	хагарах @@л
хоригоор	хорих @@г @@оор
ухуулгаар	ухах @@уулага @@аар
эрдэмтнийг	эрдэм @@тэн @@ийг
компаниас	компани @@ас
хурлаас	хурал @@аас
шивнэх	шивнэх
баашны	бааш @@ы
хүндрэлийг	хүнд @@рэх @@л @@ийг
хүйтнийг	хүйтэн @@ийг
хутгаа	хутга @@аа
тэлэлтээр	тэлэх @@лт @@ээр
хэмжээгээ	хэмжих @@ээ @@ээ
албаждаг	алба @@жих @@даг
канон	канон
зогсоолоос	зогсох @@оох @@л @@оос
видеог	видео @@г
амьдчилах	амь @@д @@члах
таамаглалыг	таах @@маг @@лах @@л @@ыг
хохирлыг	хохирох @@л @@ыг
дараалах	дараа @@лах
луугаа	луу @@аа
сайжруулалтаар	сайн @@жрах @@уулах @@лт @@аар
ирмэгтэй	ирмэг @@тэй
амиа	ами @@а
шүтээн	шүтэх @@ээн
хуваагдлаас	хуваах @@гдах @@л @@аас
дэвших	дэвших
зохицлыг	зохих @@цох @@л @@ыг
өндөгний	өндөг @@ий
хачирхал	хачирхах @@л
тогтолцоо	тогтлох @@цоо
шилэх	шилэх
тэтгэмжийг	тэтгэх @@мж @@ийг
хурдасгуурт	хурд @@сгах @@уур @@т
гаансыг	гаанс @@ыг
сумангаар	сум @@н @@ааар
чадвараа	чадавар @@аа
мастерын	мастер @@ын
хэвшлээ	хэвшил @@ээ
өрсөлдөгчөө	өрсөх @@лдөх @@гч @@өө
томдох	томдох
ээтийвэл	ээтийх @@вэл
хурдасгал	хурд @@сгах @@л
ноогдлоос	ноогдох @@л @@оос
үдэшлэгээс	үдэшлэг @@ээс
талийгаач	талийх @@гаач
амбаартай	амбаар @@тай
хүнээ	хүн @@ээ
эвлэрээсэй	эв @@лэх @@рээсэй
дагалдагчаар	дага @@лдах @@гч @@аар
хэрэгтнээ	хэрэг @@тэн @@ээ
асрыг	асар @@ыг
цуу	цуу
түрээсний	түрээс @@ий
мөнхөжье	мөнх @@жих @@е
илтгэлийн	илтгэх @@л @@ийн
хүсэлтэй	хүсэх @@л @@тэй
талбараар	талбар @@аар
наймааны	наймаа @@ы
ажиглагчаас	ажих @@г @@лах @@гч @@аас
орлох	ор @@лох
зээрэнцгээ	зээрэнцгэ
хорив	хорих @@в
саадтай	саад @@тай
хөдөлмөрийг	хөдлөх @@мөр @@ийг
лампнаас	ламп @@аас
булангаас	булан @@аас
дамчин	дам @@чин
сэдэгчийг	сэдэх @@гч @@ийг
майонезын	майонез @@ын
хувирлыг	хувирах @@л @@ыг
сэрвээний	сэрвээ @@ий
чиргүүлийг	чирэх @@гүүл @@ийг
тусгалд	тусах @@гал @@д
эвэрлэгийг	эвэр @@лэг @@ийг
соруул	соруул
доллартой	доллар @@той
таваас	тав @@аас
дизайнер	дизайнер
тавиураас	тавих @@уур @@аас
ардчиллаар	ард @@члах @@л @@аар
дайралтыг	дайн @@рах @@лт @@ыг
бэл	бэл
янжуурын	янжуур @@ын
ваарт	ваар @@т
тэгшитгэл	тэгш @@тгэх @@л
ханшийн	ханш @@ийн
өрцөнд	өрц @@д
үнэгтэй	үнэг @@тэй
зөрөлдөөнөөр	зөрөх @@лдөх @@өөн @@өөр
тангонд	танго @@д
хяналтын	хянах @@лт @@ын
хэрэглэх	хэрэг @@лэх
залгаасаар	залга @@аас
паспортоо	паспорт @@оо
эрлээ	эрэл @@ээ
графиктай	график @@тай
хоромд	хором @@д
түших	түших
нумтай	нум @@тай
наймаачинд	наймаа @@чин @@д
ахлагчаас	ах @@лах @@гч @@аас
эдэлгээ	эд @@лэх @@г @@ээ
хөхөвч	хөх @@вч
судлаачаа	судлах @@аач @@а
араанаас	араа @@аас
хэвлэгчээс	хэв @@лэх @@гч @@ээс
дэлгэрүүлэх	дэлгэх @@рэх @@үүлэх
томоогүй	томоо @@гүй
азотын	азот @@ын
дагаврын	дагавар @@ын
мурийх	мурийх
гомдлоо	гомдох @@л @@оо
хуудуутай	хуудах @@уу @@тай
уршигтай	уршиг @@тай
хараалыг	хараах @@л @@ыг
үсэглэлээ	үсэг @@лэх @@л @@ээ
инженертэй	инженер @@тэй
сүнсээр	сүнс @@ээр
мэнгэнээс	мэнгэ @@ээс
зөрчигч	зөрчих @@гч
генералаа	генерал @@аа
томилгоотой	томилох @@гоо @@той
үрчлээтэй	үрчлэх @@ээ @@тэй
андгай	андгай
медалиас	медаль @@ас
хөндийрье	хөндийнер
холестеринтой	холестерин @@той
мөнгөөр	мөнгө @@өөр
хөнгөхөн	хөнгөх @@өөн
ёсолгоонд	ёс @@лгоо @@д
байг	байг
ритм	ритм
хамтрагчаас	хамтрах @@гч @@аас
махаар	мах @@аар
эвийн	эв @@ийн
ардчиллын	ард @@члах @@л @@ын
шившигтэй	шившиг @@тэй
булчинтай	булчин @@тай
дэлгэцэд	дэлгэх @@ц @@д
сонсогчийг	сонсох @@гч @@ийг
магтаалаас	магтах @@аал @@аас
уранаа	ур @@н @@аа
бөөгнөрлөөр	бөөгнөрөх @@л @@өөр
капитализмд	капитализм @@д
дэгээнээс	дэгээ @@ээс
хөлслөгчийн	хөлс @@лөх @@гч @@ийн
фронтод	фронт @@д
организмтой	организм @@той
холдуулах	холдох @@уулах
мануухайг	мануухай @@г
мэнгэтэй	мэнгэ @@тэй
онош	онош
туслалцааны	тус @@лах @@лцах @@аа @@ы
нэмэгдүүлэх	нэмэх @@гдэх @@үүлэх
магтаалаар	магтаал @@аар
ургамлыг	ургах @@мал @@ыг
хандлагын	хандалага @@ын
ходоодноос	ходоод @@оос
давтамжид	давтах @@мж @@д
жүжигчинтэй	жүжиг @@чин @@тэй
гарын	гар @@ын
давхаргаас	давхар @@гаас
судраар	судар @@аар
зорилго	зорих @@лго
шилбэтэй	шилбэ @@тэй
стратегиа	стратеги
шоглоомыг	шог @@лох @@оом @@ыг
шаналалтай	шаналах @@л @@тай
бүлэгтэй	бүлэг @@тэй
бодисоор	бодис @@оор
үед	үе @@д
үнэлэмжээр	үнэ @@лэх @@мж @@ээр
авьяастанд	авьяас @@тан @@д
бондын	бонд @@ын
гайхшруулах	гайх @@ших @@уулах
шүүхийн	шүүх @@ийн
паалантай	паалан @@тай
лууг	луу @@г
баталгааны	батал @@гаа @@ы
алтнаас	алт @@аас
оршуулах	орших @@уулах
сэжигтнийг	сэжиг @@тэн @@ийг
цэргээ	цэрэг @@ээ
чимгийн	чимэг @@ийн
найрамдлаас	найрах @@мдал @@аас
эрхлэгчээ	эрхлэх @@гч @@ээ
философийн	философи @@ийн
харвин	харвин
хоригоос	хорих @@г @@оос
гулсуураа	гулсах @@уур @@аа
давтамжтай	давтах @@мж @@тай
баримтын	барих @@мт @@ын
ёгтлох	ёгт @@лох
бэлтгэлээс	бэлтгэх @@л @@ээс
шохойн	шохой @@н
даяаршцгаа	даяар @@ших @@цга
асарт	асар @@т
дарамттай	дарам @@тай
хайлшны	хайлах @@ш @@ы
байгууллагатай	байх @@уулах @@лага @@тай
сэтгэлийн	сэтгэх @@л @@ийн
явуулгыг	явах @@уулага @@ыг
нумыг	нум @@ыг
түгээсэй	түг @@ээсэй
таславч	тас @@лах @@вч
адилслаар	адил @@сах @@л @@аар
дарангуйлагчийг	дарах @@нгуй @@лах @@гч @@ийг
гуйлгачинд	гуйх @@лгч @@д
эс	эс
овоо	ов @@оо
гишүүнээс	гишүүн @@ээс
баримжаатай	барих @@мжаа @@тай
эргэлзэлтэй	эргэлзэх @@л @@тэй
бэрээс	бэр @@ээс
бөгж	бөгж
далилзсан	далий @@лзан
судалгаанд	судлах @@гаа @@д
жолоодох	жолоо @@дох
эзлэгч	эзлэх @@гч
худгийг	худаг @@ийг
адилслыг	адил @@сах @@л @@ыг
дээсээр	дээс @@ээр
этгээдтэй	этгээд @@тэй
маажинг	маажин @@г
авхуулсан	авах @@уулас @@н
бадрах	бадрах
хамтрагчаар	хамтрах @@гч @@аар
нийгэмлэг	нийгэм @@лэг
ялагдагчийн	ялагдах @@гч @@ийн
атираатай	атираа @@тай
нум	нум
гөжүүд	гөжүү @@д
гавьяа	гавьяа
харьтын	харьт @@ын
сүүдрэвчид	сүүдэр @@вч @@д
зурвасыг	зурах @@вс @@ыг
жагсаал	жагсах @@аал
элэгдлийг	элэг @@дэх @@л @@ийг
хугарлаа	хугарах @@л @@аа
гүүр	гүүр
нуурт	нуур @@т
эвдчээсэй	эвдэх @@ч @@ээсэй
мэндчилгээтэй	мэнд @@члэх @@гээ @@тэй
төөрөгдлөөс	төөрөх @@гдөх @@л @@өөс
хөшүүргээ	хөших @@үүрэг @@ээ
тэргүүлэгчээс	тэргэх @@үүлэх @@гч @@ээс
номоор	ном @@оор
тэнүүлд	тэнүүл @@д
байлдагч	байлдах @@гч
гаслангийн	гаслан @@ийн
шувуугаар	шувуу @@аар
тархалтаас	тарах @@х @@лт @@аас
экосистемээс	экосистем @@ээс
чангарлаар	чанга @@рах @@л @@аар
ханцуйнаас	ханцуй @@аас
агааржуулагчаа	агаар @@жих @@уулах @@гч @@а
өөхний	өөх @@ий
адыг	ад @@ыг
боловсролт	боловсрох @@лт
цохилтыг	цохих @@лт @@ыг
акт	акт
дэртэй	дэр @@тэй
тэвчээрээ	тэвчих @@ээр @@ээ
удирдамж	удирдах @@мж
гэрэлтүүлэгт	гэрэл @@тэх @@үүлэх @@г @@т
цавиа	цавь @@а
хөхтэй	хөх @@тэй
тивтэй	тив @@тэй
асуудалд	асуух @@дал @@д
нягтшилтай	нягт @@ших @@л @@тай
дүрслэлээр	дүрс @@лэх @@л @@ээр
мэдээний	мэдээ @@ий
үерхэлд	үерхэх @@л @@д
гэдэсний	гэдэс @@ий
лактай	лак @@тай
шилжилтээ	шилжих @@лт @@ээ
шүтэлцээгээр	шүтэх @@лцээ @@ээр
хийсвэрлэлд	хийсвэр @@лэх @@л @@д
капитализмаа	капитализм @@аа
шилэлт	шилэл @@т
адмиралтай	адмирал @@тай
титмийг	титэм @@ийг
цэрдээ	цэрд @@ээ
зүйрлэх	зүйр @@лэх
диаметрт	диаметр @@т
хамсаатан	хам @@саа @@тан
тохиролцоог	тохирох @@лцох @@оо @@г
чухал	чухал
видеоноос	видео @@оос
барменээс	бармен @@ээс
дэлгэрэлтээр	дэлгэрэх @@лт @@ээр
ширгийг	ширэг @@ийг
өнгөнд	өнгө @@д
зодооноо	зодох @@оо @@оо
зоригийн	зориг @@ийн
хорголжийн	хорголж @@ийн
тактиктай	тактик @@тай
урвагчаас	урвах @@гч @@аас
даамжралаар	даамжрах @@л @@аар
могойтой	могой @@той
мөргөлчинтэй	мөргөх @@л @@чин @@тэй
лавлахын	лав @@лах @@ын
байршлаар	байр @@ших @@л @@аар
индексийг	индекс @@ийг
хондлойд	хондлой @@д
сейф	сейф
үнсэлтээ	үнсэх @@лт @@ээ
амлалтаа	амлах @@лт @@аа
бодролоор	бодорох @@л @@оор
ховилтой	ховил @@той
даажин	даажин
сульдах	суль @@дах
амтанд	ам @@т @@д
шүүмжээс	шүүх @@мж @@ээс
хэлцлээр	хэлцэх @@л @@ээр
мөрдөстэй	мөрдөс @@тэй
хамгааллыг	хамгаалах @@л @@ыг
төмсөгтэй	төмсөг @@тэй
гахиурыг	гахиур @@ыг
ханш	ханш
сүнстэй	сүнс @@тэй
эгчийг	эгч @@ийг
архиа	архи @@а
хилэгнэл	хилэнгнэх @@л
хандах	хандах
ажилд	ажил @@д
үргүйдэх	үр @@гүй @@дэх
тохид	тохь @@д
бөмбөгийг	бөмбөг @@ийг
хуй	хуй
сорилттой	сорил @@той
бололцоо	болох @@лцоо
казиногийн	казино @@ийн
багсаар	багс @@аар
чулуунд	чулуу @@д
нөхөөснөөс	нөхөөс @@өөс
танкны	танк @@ы
эвслийг	эвсэх @@л @@ийг
дагалдах	дага @@лдах
организмоос	организм @@оос
саун	саун
өв	өв
услагчаар	ус @@лах @@гч @@аар
үүргээр	үүрэг @@ээр
туурайг	туурай @@г
хорхойг	хорхой @@г
цочролыг	цочрох @@л @@ыг
хоршлоос	хорших @@л @@оос
сонсогчоос	сонсох @@гч @@оос
хувьсагчаас	хувь @@сах @@гч @@аас
хоцрогчийн	хоцрох @@гч @@ийн
цардуултай	цардах @@уул @@тай
вирусээр	вирус @@ээр
заламгайгаар	заламгай @@аар
илгээмжийг	илгээх @@мж @@ийг
болзох	болзох
засварчинд	засах @@вчир @@д
амьжиргаа	амьжих @@ргаа
сэвийн	сэв @@ийн
зараатай	зараа @@тай
туурайтай	туурай @@тай
төвлөрлөөр	төв @@лрөх @@л @@өөр
эвдэчвэл	эвдэх @@чих @@вэл
шаазангийн	шаазан @@ийн
сэжүүр	сэжүүр
төр	төр
өмч	өмч
хурданд	хурд @@д
бэлэгт	бэлэг @@т
уйтгараас	уйтгар @@аас
материализм	материализм
дэлхийд	дэлхий @@д
залгаасны	залгах @@аас @@ы
хилэгнэлээр	хилэн @@гнэх @@л @@ээр
хэрүүлээр	хэрүүл @@ээр
хоньчинд	хонь @@чин @@д
хөлстэй	хөлс @@тэй
үгээр	үг @@ээр
майонез	майонез
сонсго	сонсго
саланги	саланги
голын	гол @@ын
гэмгүй	гэм @@гүй
дэвтэртэй	дэвтэр @@тэй
энгэртэй	энгэр @@тэй
залуур	залах @@уур
тусламжид	тус @@лах @@мж @@д
цохилтоо	цохих @@лт @@оо
хөөлгө	хөөх @@лөг
тулалдаанд	тулалдах @@аа @@д
араншингийн	араншин @@ийн
жоотуугаа	жоотуу @@аа
завхай	завхай
эсрэгцлээ	эсрэг @@цэх @@л @@ээ
мөрдөгчийг	мөр @@дөх @@гч @@ийг
цохисон	цохих @@сон
зогсолт	зогсох @@лт
майонезаас	майонез @@аас
орчуулгад	орчуулах @@га @@д
программ	программ
гагнуур	гагнуур
хуримтай	хурим @@тай
тавилга	тавих @@лга
харьцуулалтаас	харьцах @@уулах @@лт @@аас
будгийн	будаг @@ийн
чөлөөлөлтөөс	чөлөө @@лөх @@лт @@өөс
ёзоороор	ёзоор @@оор
эвлэрлээр	эв @@лэрэх @@л @@ээр
хувьсгал	хувь @@сгах @@л
хуулиас	хууль @@ас
бэлтгэлийг	бэлтгэх @@л @@ийг
шингэлтээ	шингэх @@лт @@ээ
луйварчинтай	луйвар @@чин @@тай
оромжоор	орох @@мж @@оор
онолчоо	онох @@лч @@оо
хариуцах	харих @@уу @@цах
хормоор	хором @@оор
ахлагчид	ах @@лах @@гч @@д
хүүхэлдэйгээр	хүүхэд @@лдэй @@ээр
зартай	зар @@тай
хашилтаа	хаш @@лт @@аа
цэгээс	цэг @@ээс
адраас	адар @@аас
дулааралгүй	дулаарах @@лгүй
протоколд	протокол @@д
соёлжтол	соёл @@жих @@л
эргүүл	эргэх @@үү
гурилд	гурил @@д
төлбөрийн	төлөх @@бөр @@ийн
гурвалаар	гурав @@л @@аар
цөлийг	цөл @@ийг
удмаас	удам @@аас
хийлээр	хийл @@ээр
мөнхөөр	мөнх @@өөр
задралаар	зад @@рах @@л @@аар
тусгаарлагдах	тусах @@гаар @@лах @@лга @@д
зүрх	зүрх
мэрэгчийг	мэрэх @@гч @@ийг
цэнгүүнд	цэнгэх @@үүн @@д
хэргээ	хэрэг @@ээ
дүрслэх	дүрс @@лэх
дамд	дам @@д
геологио	геологи
харамслаас	харамсах @@л @@аас
таргын	тарга @@ын
хашлаганаас	хаших @@лага @@аас
тайрах	тайрах
устгалд	устах @@гал @@д
тоосгоо	тоосго @@оо
сүүдрэвчийн	сүүдэр @@вч @@ийн
ажиллагаанд	ажил @@лах @@гаа @@д
цуглуулагчид	цуг @@лах @@уулах @@гч @@д
алчуураар	алчуур @@аар
хийлтэй	хийл @@тэй
даяаршъя	даяар @@ших @@я
тахиа	тахиа
хожуулаас	хожуул @@аас
глюкозтой	глюкоз @@той
тохиролцоо	тохирох @@лцох @@оо
зарлалаа	зар @@лах @@л @@аа
цэнгэлийн	цэнгэх @@л @@ийн
хөшье	хөшь
керамиктай	керамик @@тай
ороолтоос	ороох @@лт @@оос
бүрэлбаагаа	бүрэлбаа @@аа
тарих	тарих
цилиндрээс	цилиндр @@ээс
танк	танк
харьцуулалтад	харьцах @@уулах @@лт @@д
хямрах	хямрах
гуа	гуа
яарах	яарах
фермент	фермент
тайлбараар	тайл @@бар @@аар
амьжиргааны	амьжих @@ргаа @@ы
талбараас	талбар @@аас
бөөрийг	бөөр @@ийг
ресторанд	ресторан @@д
хорьсон	хорих @@сон
залгааг	залгах @@аа @@г
найрууламжаа	найрах @@уулах @@мж @@а
илрүүлэлт	илрэх @@үүлэх @@лт
нуруутай	нуруу @@тай
шохойжмогц	шохой @@жимогц
харуусал	харуусах @@л
социализмаа	социализм @@аа
зүлгүүрийн	зүлгэх @@үүр @@ийн
хожуулд	хожуул @@д
нөөцөө	нөөх @@ц @@өө
хангалтыг	хангах @@лт @@ыг
хөлд	хөл @@д
хольцод	холих @@ц @@д
мэдрэмж	мэдрэх @@мж
ухагдахуун	ухах @@гдах @@уун
спиртийг	спирт @@ийг
дилертэй	дилер @@тэй
өвөө	өвөө
дээрмийн	дээрэм @@ийн
мэдээлжээ	мэдэх @@ээ @@лж @@ээ
алуурчнаа	алуур @@чин @@аа
картад	карт @@д
хөршөө	хөрш @@өө
арштай	арш @@тай
хөлгийг	хөлөг @@ийг
заан	заан
хангах	хангах
цэрэг	цэрэг
дэгдэлтэд	дэгдэх @@лт @@д
харвингийн	харвин @@ийн
эргэлзлийн	эргэлзэх @@л @@ийн
хамгаалалд	хамгаалах @@л @@д
дайчилгаагаар	дайн @@члах @@га @@аар
чадварын	чадах @@вар @@ын
онцлогт	онц @@лог @@т
статистикийг	статистик @@ийг
амьдралтай	амь @@драх @@л @@тай
цэврүүгээр	цэврүү @@ээр
сонсох	сонсох
шивээсээс	шивээс @@ээс
туршуултай	турших @@уул @@тай
чангалуурын	чанга @@лах @@уур @@ын
анхааруулгын	анхаарах @@уулах @@лга @@ын
тэмцэл	тэмцэх @@л
бүтэлгүйтэлд	бүтэх @@лгүй @@д
зуунаа	зуун @@аа
зөрөлдөөнд	зөрөх @@лдөх @@өөн @@д
цамцны	цамц @@ы
бөндгөрийг	бөндгөр @@ийг
маргаанаа	маргаа @@аа
тохуугаар	тохуу @@аар
түгшүүрийг	түгших @@үүр @@ийг
төөрөлдөх	төөрөх @@лдөх
жараахайгаар	жараахай @@аар
дэнстэй	дэнс @@тэй
өвлөөс	өвөл @@өөс
орчуулгын	орчуулах @@га @@ын
үүдэнд	үүд @@д
сам	сам
араншинтай	араншин @@тай
халим	халим
компанитай	компани @@тай
кодоо	код @@оо
гундуу	гундуу
тангарагт	тангараг @@т
бодис	бодис
нимбэгээ	нимбэг @@ээ
фокусын	фокус @@ын
идэгдэх	идэх @@гдэх
улайрсан	улайрсан
мэдрэмжийг	мэдрэмж @@ийг
зайнаас	зай @@аас
хамсаатанд	хам @@саат @@д
цондонгоо	цондон @@оо
зэвүүцлийн	зэвүү @@цэх @@л @@ийн
дайчнаа	дай @@чин @@аа
түдгэлзүүлэх	түдгэлзэх @@үүлэх
шалгалтыг	шалгах @@лт @@ыг
молекултай	молекул @@тай
өрсөлдөгчөөс	өрсөх @@лдөх @@гч @@өөс
давхрага	давхар @@га
даяаршингаа	даяар @@шин @@аа
шүүгчид	шүүх @@гч @@д
ялгаруулалттай	ялгах @@рах @@уулах @@лт @@тай
зүүд	зүү @@д
манлайллаар	манлай @@лаар
хагацалтай	хагацах @@л @@тай
мансуурлын	мансуурах @@л @@ын
төвлөрүүлэлтээр	төв @@лрөх @@үүлэх @@лт @@ээр
текстээ	текст @@ээ
хөрөнгөтөн	хөрөнгө @@төн
савхадъя	савх @@дах @@я
томьёогоо	томьёо @@оо
тамхичинд	тамхи @@чин @@д
аэробик	аэробик
үнийг	үн @@ийг
шангаас	шан @@аас
тавиуртай	тавих @@уур @@тай
голомтоо	голомт @@оо
экологио	экологи
торнимогц	торних @@могц
хөнгөлөлтөө	хөнгө @@лөх @@лт @@өө
орлогчид	ор @@лох @@гч @@д
дамжуулагчид	дамжиулах @@гч @@д
бутралд	бут @@рах @@л @@д
мөлжлөгийг	мөлжих @@лөг @@ийг
тогтоолоос	тогтох @@оох @@л @@оос
хурлаа	хурал @@аа
цэнгүүн	цэн @@гүүн
цалинд	цалин @@д
өмсгөлтэй	өмсөх @@гөх @@л @@тэй
туурайд	туурай @@д
бадминтон	бадминтон
үйлдлээс	үйл @@дэх @@л @@ээс
бөглөөнд	бөглөх @@өө @@д
магадлагаа	магад @@лах @@гаа
экваторт	экватор @@т
илгээгчээр	илгээх @@гч @@ээр
заналхийлэлтэй	занал @@хийлэх @@л @@тэй
хөдлөлд	хөдлөх @@л @@д
оператортай	оператор @@тай
ботаникаа	ботаник @@аа
хүндээс	хүнд @@ээс
эвдрэлийг	эвдрэх @@л @@ийг
масштабыг	масштаб @@ыг
өчгийн	өчиг @@ийн
онолоос	онох @@л @@оос
дагалдагчид	дага @@лдах @@гч @@д
капитализмын	капитализм @@ын
автобуснаас	автобус @@аас
солбицолгүй	солбих @@цох @@лгүй
банзны	банз @@ы
элгийг	элэг @@ийг
галлалттай	гал @@лах @@лт @@тай
улнаас	ул @@аас
туршуул	туршиул
батал	батал
буртаг	буртаг
ширгийн	ширэг @@ийн
гүйлтийг	гүйх @@лт @@ийг
илбэчний	илбэ @@ч @@ий
уялдаанаас	уях @@лдах @@аа @@аас
бонд	бон @@д
сийрэгжилгүй	сийрэг @@жих @@лгүй
хадуураас	хадуур @@аас
үүдтэй	үүд @@тэй
стандартыг	стандарт @@ыг
тандагч	тандах @@гч
зараас	зар @@аас
гоёлд	гоё @@л @@д
нэгтгэх	нэгт @@гэх
даяаршина	даяар @@шин
солбицтол	солбих @@цох @@л
радиог	радио @@г
харилцуураа	харилцах @@уур @@аа
тушаалаар	тушаал @@аар
нягтаршлаа	нягтар @@ших @@л @@аа
худгаа	худаг @@аа
жишгээр	жишиг @@ээр
хуримтлалд	хурим @@тлах @@л @@д
тарилгаар	тарих @@лга @@аар
хөнгөмсөг	хөнгөх @@мөг
тогтворгүй	тогтох @@вор @@гүй
болзолтой	болзох @@л @@той
сорилгыг	сорих @@лго @@ыг
тивээ	тив @@ээ
дэвүүртэй	дэвүүр @@тэй
ёгтлолын	ёгт @@лох @@л @@ын
зайрмаг	зайрмаг
нэрд	нэр @@д
гинжээр	гинж @@ээр
бүрэх	бүрэх
асуулгаа	асуух @@лга @@аа
эзэмшигчид	эзэн @@мших @@гч @@д
боргионд	боргио @@д
дуншилтаа	дунших @@лт @@аа
шалгалтад	шалгах @@лт @@д
харьцал	харих @@цал
холестериноор	холестерин @@оор
тахицгаа	тахих @@цг @@аа
дохиогоор	дохио @@оор
үзүүлэх	үзэх @@үүлэх
гортигоо	гортиг @@оо
солбицвол	солбицох @@вол
эстэй	эс @@тэй
эсрэгцлийн	эсрэг @@цэх @@л @@ийн
асрын	асар @@ын
уулд	уул @@д
найрамдлыг	найрах @@мдах @@л @@ыг
тавиурыг	тавиур @@ыг
хөтлөгчөөс	хөтлөх @@гч @@өөс
хоригийн	хориг @@ийн
үйл	үйл
жаягаа	жаяг @@аа
цуглаанд	цуг @@лах @@аа @@д
барилгатай	барих @@лга @@тай
солонгоо	солон @@оо
хирсийн	хирс @@ийн
цэнгэлд	цэнгэх @@л @@д
дулаартал	дулаар @@тах @@л
чагнаал	чагнах @@аал
наалтад	наах @@лт @@д
хөршөөс	хөрш @@өөс
чононд	чоно @@д
чийгшлийн	чийг @@шил @@ийн
дарангуйлагчийн	дарах @@нгуй @@лах @@гч @@ийн
эгнээтэй	эгнэх @@ээ @@тэй
элемент	элемент
донсолгоонд	донслох @@гоо @@д
голионоос	голио @@оос
циркээс	цирк @@ээс
шугуйг	шугуй @@г
тунах	тунах
хорвоотой	хорвоо @@той
аршийн	арш @@ийн
услагчийн	услах @@гч @@ийн
имтэй	им @@тэй
тулалдааныг	тулах @@лдах @@аан @@ыг
арлыг	арал @@ыг
байршуулах	байр @@ших @@уулах
эргэлзлээ	эргэлзэх @@л @@ээ
дэмжигчид	дэмжих @@гч @@д
үнэмшилд	үнэн @@мших @@л @@д
ялалт	ялах @@лт
шороотой	шороо @@той
ажиллая	ажил @@лах @@я
тэлэлтэд	тэлэх @@лт @@д
үзмээ	үзэм @@ээ
боржин	боржин
актын	акт @@ын
унжлага	унжих @@лага
боловсролоор	боловсрох @@л @@оор
лаанд	лаа @@д
арифметикаар	арифметик @@аар
буурийг	буурь @@ийг
шүүсээс	шүүс @@ээс
жатгаа	жатга @@аа
цайгаар	цай @@аар
бэлийг	бэл @@ийг
биллиардтай	биллиард @@тай
хаягт	хаяг @@т
хэвийн	хэв @@ийн
дэлгүүрийн	дэлгэх @@үүр @@ийн
нөхөөсөөр	нөх @@өөс @@өөр
илтэй	ил @@тэй
сөнөөгчид	сөнөөх @@гч @@д
нуманд	нум @@д
хэлэлцэгчийг	хэлэлцэх @@гч @@ийг
бичиглэлээ	бичих @@г @@лэх @@л @@ээ
мухлагаа	мухлаг @@аа
цуурайтай	цуурай @@тай
хэмжээнээс	хэм @@жих @@ээ @@ээс
найраар	найр @@аар
цувралын	цуврах @@л @@ын
ордноор	орд @@оор
дэлгэцтэй	дэлгэх @@ц @@тэй
шавах	шавах
моодоор	моод @@оор
өчигдөр	өчигдөр
чангарал	чангарах @@л
чиглэлтэй	чиг @@лэх @@л @@тэй
гишүүнийг	гишүүн @@ийг
мөргөлөөр	мөргөх @@л @@өөр
өмсгөл	өмсөх @@гөл
тоншуул	тоншуул
шпагеттиа	шпагетти @@а
тогтох	тогтох
гуядах	гуядах
татвараас	татах @@вар @@аас
барилгаас	барих @@лга @@аас
диаметрээ	диаметр @@ээ
далдлалттай	далд @@лах @@лт @@тай
ихсээ	ихэс @@ээ
чихэр	чихэр
мэхлэлтийг	мэх @@лэх @@лт @@ийг
уялдаатай	уях @@лдах @@аа @@тай
дээвэртэй	дээвэр @@тэй
дэвшлийг	дэвших @@л @@ийг
жигшлээр	жигших @@л @@ээр
явуулах	явах @@уулах
шууданчаар	шуудан @@ч @@аар
бахархлаар	бахар @@хах @@л @@аар
утаагаа	утаа @@аа
нууцлалд	нууц @@лах @@л @@д
өнцгийн	өнцөг @@ийн
дэнсээр	дэнс @@ээр
цөмөөс	цөм @@өөс
боолоо	боол @@оо
дүнзээ	дүнз @@ээ
цогцостой	цогцос @@той
зөвлөмж	зөв @@лөх @@мж
тэвчээрээр	тэвчих @@ээр @@ээр
амьдрал	амь @@драл
борлуулалтын	борлох @@уулах @@лт @@ын
дүгнэлтийг	дүгнэх @@лт @@ийг
физиологид	физиологи @@д
нэмэлтээс	нэмэх @@лт @@ээс
оролцоог	орлох @@цоо @@г
уянгыг	уян @@ыг
киноны	кино @@ы
дэвшил	дэвших @@л
бэлчээрт	бэлчих @@ээр @@т
зэрэгт	зэрэг @@т
ертөнц	ертөнц
слайдад	слайд @@д
шугуйгаа	шугуй @@аа
хямдралаа	хямд @@рах @@л @@аа
уурхайд	уурхай @@д
хөнөөл	хөнөх @@л
уриалгыг	урих @@аа @@л @@ыг
цэцэглэлтээ	цэцэг @@лэх @@лт @@ээ
сэнстэй	сэнс @@тэй
тээвэрлэлтийг	тээх @@вэр @@лэх @@лт @@ийг
сонсвол	сонсов @@л
устгагч	устгах @@гч
тэгшлэх	тэгш @@лэх
физиологитой	физиологи @@той
өвгөнд	өвгө @@д
баярлах	баяр @@лах
бугуй	бугуй
багтрах	багт @@рах
хэмнэлээр	хэм @@нэл @@ээр
цэцэг	цэцэг
бүлгээ	бүлэг @@ээ
нууцаар	нуух @@ц @@аар
хоцрогдлын	хоцрох @@гдох @@л @@ын
хугарал	хугарах @@л
нахиагаа	нахиа @@аа
нэр	нэр
хувьсгалыг	хувь @@сах @@гах @@л @@ыг
дэгээгээр	дэг @@эээр
консулд	консул @@д
бахинаас	бахь @@аас
хананд	ханан @@д
хөтчөө	хөтөч @@өө
дутагдлаас	дутах @@гдал @@аас
тэмдэгт	тэмдэг @@т
урвалаар	урвах @@л @@аар
цэцэрлэгийн	цэцэрлэг @@ийн
хамгааллаас	хамгаалах @@л @@аас
бээлийтэй	бээлий @@тэй
суралцагчийн	сурах @@лцах @@гч @@ийн
захиалагч	захиа @@лах @@гч
мөрдөх	мөр @@дөх
бутралаас	бут @@рах @@л @@аас
наймаагаа	наймаа @@аа
товчлуур	товч @@лох @@уур
зураастай	зурах @@аас @@тай
сургаалаас	сургах @@аал @@аас
тохироотой	тохирох @@оо @@той
хөдөлмөрчнөө	хөдлөх @@мөр @@чин @@өө
захиагаар	захиа @@аар
даяарштал	даяар @@ших @@тал
жолоочийг	жолоо @@ч @@ийг
чичиргээтэй	чичрэх @@гээ @@тэй
шивнээний	шивнэ @@ээ
зүйрлэлд	зүйр @@лэх @@л @@д
оёдолд	оёх @@дол @@д
тохируулгаа	тохирох @@уулах @@га @@а
зурангаа	зуран @@аа
хүүрнэлээ	хүүрнэх @@л @@ээ
бадминтоны	бадминтон @@ы
лимбэддэг	лимбэ @@д
оньслох	оньс @@лох
зангаагаа	зангаа @@аа
үйлчлэгчтэй	үйл @@члэх @@гч @@тэй
танилцуулгаас	таних @@л @@цах @@уулах @@лгаас
битүүлгээ	битүү @@лэх @@гээ
ритмээ	ритм @@ээ
уургийн	уураг @@ийн
нэвтрүүлэгчээс	нэвтрэх @@үүлэх @@гч @@ээс
үндэстэй	үндэс @@тэй
найзыг	найз @@ыг
ир	ир
гаслантай	гаслан @@тай
чимхүүрээс	чимхэх @@үүр @@ээс
номыг	ном @@ыг
ташуурын	таших @@уур @@ын
ялгадсаар	ялгадас @@аар
давтамж	давтах @@мж
торнимоор	торним @@оор
товойтол	товойх @@тол
шунал	шунал
дамжуулалтад	дам @@жих @@уулах @@лт @@д
хүчлээр	хүчил @@ээр
азтай	аз @@тай
хэвлэлтэй	хэв @@лэх @@л @@тэй
тэрэгтэй	тэрэг @@тэй
амттанд	амт @@тан @@д
дүүргэлтэд	дүүргэх @@лт @@д
ноогдолтой	ноогдох @@л @@той
уцаарын	уцаар @@ын
үлгэрээр	үлгэр @@ээр
зарлагаас	зар @@лаг @@аас
хүсэлтийн	хүсэх @@лт @@ийн
ачид	ач @@д
сүлжээний	сүлжих @@ээ @@ий
бяслагаас	бяслаг @@аас
ургамлаа	ургам @@л @@аа
зэвийг	зэв @@ийг
шоштой	шош @@той
чимгээр	чимэг @@ээр
соёлжоосой	соёл @@жоосой
шархны	шарх @@ы
гахайнаас	гахай @@аас
шаналгааны	шаналаг @@ы
хэлмэгдэлгүй	хэлмэгдэх @@лгүй
пайзаа	пайз @@аа
анчныг	анчин @@ыг
цардастай	цардас @@тай
үндэслэл	үндэс @@лэх @@л
дайралтаар	дайн @@рах @@лт @@аар
тохижуулалтыг	тохижих @@уулах @@лт @@ыг
баривчилгааг	барих @@вч @@лах @@гаа
дасгалын	дасгал @@ын
шошоо	шош @@оо
цэвэрлэгээний	цэвэр @@лэг @@ийн
мэдрэгдэх	мэдрэх @@гдэх
маскийг	маск @@ийг
санаа	сан @@аа
самнаас	сам @@аас
товхимолд	товхимол @@д
дасгалжуулагчаас	дасгал @@жих @@уулах @@гч @@ас
дэвсгэр	дэвсэг
тэвхдэнгээ	тэвх @@дэх @@нгээ
сондгойронгоо	сондгой @@рох @@нгоо
хүртвэр	хүртэв
слайдаар	слайд @@аар
утгаас	утга @@аас
хүлээсийг	хүлээс @@ийг
дурсамжийг	дурсах @@мж @@ийг
ангаахайгаар	ангаахай @@аар
шилбээ	шилбэ @@ээ
бүргэдтэй	бүргэд @@тэй
үргүйдэлд	үргүй @@дэх @@л @@д
шүүгчийн	шүүх @@гч @@ийн
цоожноос	цоож @@оос
сүр	сүр
тотио	тоть @@о
онтой	он @@той
бөөмтэй	бөөм @@тэй
удирдлага	удирдах @@лага
эрэлтээр	эрэх @@лт @@ээр
захиргаагаа	захир @@гаа @@аа
засвар	засах @@в
туслалцаанаас	тус @@лах @@лцах @@аа @@ас
амраар	амар @@аар
эрмэлзэлд	эрмэлзэх @@л @@д
үсний	үс @@ий
мэхлэлт	мэх @@лэх @@лт
хөрөөдчих	хөрөө @@дөх @@чих
газардах	газар @@дах
эвэрлэгээ	эвэр @@лэг @@ээ
луус	луус
автобус	автобус
тэнцвэр	тэнцэх @@в
хөгжимчнийг	хөгжим @@чин @@ийг
гадуурхлын	гадуур @@хах @@л @@ын
салаанд	салаа @@д
шандастай	шандас @@тай
хоногтой	хоног @@той
уулчнаас	уул @@чин @@аас
усталын	устах @@л @@ын
галуунаас	галуу @@аас
бэхээс	бэх @@ээс
залрах	зал @@рах
академи	академи
худагтай	худаг @@тай
хангамжаа	хангах @@мж @@аа
гаансны	гаанс @@ы
бахархах	бахар @@хах
айзмаар	айзам @@аар
инээдэмд	инээд @@д
дугуй	дугуй
хөөсөнд	хөөс @@д
эзэмшигчээр	эзэн @@мших @@гч @@ээр
газартай	газар @@тай
шийдвэрлэх	шийдэх @@вэр @@лэх
хэмнэлтээ	хэмнэх @@лт @@ээ
тэнүүл	тэнэхүүл
бяцрах	бяцрах
егөөг	егөө @@г
албажмаар	алба @@жих @@маар
танилцуулгыг	таних @@л @@цах @@уулах @@лга @@ыг
цоргонд	цорго @@д
цаас	цаас
эзэмшигч	эзэм @@ших @@гч
төвлөрүүлэх	төв @@лрөх @@үүлэх
төмсийг	төмс @@ийг
ачаагаа	ачиа @@аа
романд	роман @@д
бүсгүйг	бүсгүй @@г
сонсогч	сонсох @@гч
загасчинтай	загас @@чин @@тай
гахайгаа	гахай @@аа
дур	дур
зогсцоос	зогсох @@цос
гүйлтээс	гүйх @@лт @@ээс
ахын	ах @@ын
довыг	дов @@ыг
шатыг	шат @@ыг
социализмаас	социализм @@аас
симфонийн	симфони @@ийн
бөөгнөрөл	бөөн @@гнөрөх @@л
таагаар	таа @@аар
эмийг	эм @@ийг
савхадвал	савх @@дах @@вал
нягтшилыг	нягт @@ших @@л @@ыг
талбайд	талбай @@д
дохиураа	дохиур @@аа
радиогийн	радио @@ийн
зөвшөөрлөөр	зөв @@ших @@өөрөл @@өр
бялдуучлалаас	бялдуу @@члах @@л @@аас
хурд	хурд
бичээсний	бичих @@ээс @@ий
дадах	дадах
хурдаа	хурд @@аа
тосны	тос @@ы
алхмаа	алхах @@ма
таглааны	таг @@лах @@аа @@ы
хожуулаа	хожуул @@аа
үүргэвчээ	үүрэг @@вч @@ээ
зурхайгаа	зурах @@ай @@аа
ягштал	ягштах @@л
тагнуулаа	тагнах @@уул @@аа
хамтрал	хамтрал
дэлийг	дэл @@ийг
үзлэгтэй	үзэлэг @@тэй
хөөдөг	хөөдөг
харьяалалд	харьяа @@лах @@л @@д
мэдэгдлийг	мэдэх @@гдэх @@л @@ийг
өвчтөнтэй	өвчин @@тэй
завины	завь @@ы
хамтатгалд	хамт @@тгах @@л @@д
шард	шард
сүсэгт	сүсэг @@т
арины	ари @@ы
угсрах	угсрах
зуунаас	зуун @@аас
давталт	давтал @@т
хуралд	хурал @@д
орцтой	орц @@той
ресторантай	ресторан @@тай
организмыг	организм @@ыг
хулмасанд	хулмас @@д
хушганд	хушга @@д
хаалтыг	хаах @@лт @@ыг
амлах	ам @@лах
шүүмжлэгчээс	шүүх @@мж @@лэх @@гч @@ээс
бүдэгхэн	бүдэг @@хэн
залхуу	залхуу
бугуйг	бугуй @@г
эрэмбэд	эрэмбэ @@д
ором	ором
нээгдэх	нээгдэх
шүүмжлэгчээ	шүүх @@мж @@лэгч @@ээ
багсаа	багс @@аа
нягтшил	нягт @@ших @@л
сургалтад	сургах @@лт @@д
автомашинтай	авто @@машин @@тай
догол	догол
бахиудмагц	бахиу @@дах @@магц
онцлогийн	онц @@лог @@ийн
тодорхойлолт	тод @@рохай @@лох @@лт
дөнжийн	дөнжөө @@ийн
давхаргад	давхар @@га @@д
ял	ял
дүгнэлтийн	дүгнэх @@лт @@ийн
булангаа	булан @@аа
зангаар	занга @@аар
хилэнтэй	хилэн @@тэй
консулаас	консул @@аас
номхотгох	номхотгох
ширээсэнд	ширээс @@д
сонгуулиа	сонгох @@ууль @@а
гийчнийг	гий @@чин @@ийг
ухуулгаа	ухах @@уулах @@га
хөтчөөр	хөтөч @@өөр
өдрийн	өдөр @@ийн
ханиадтай	ханиах @@д @@тай
сайдад	сайд @@д
өвгөний	өвгөн @@ий
тохуурхлаар	тохуу @@рхах @@л @@аар
шрифтэд	шрифт @@д
дэлгэцээ	дэлгэх @@ц @@ээ
дохиурыг	дохих @@уур @@ыг
залилах	заль @@лах
ажил	ажил
шивэгчнийг	шивэгчин @@ийг
хөшмөгц	хөшимөгц
нидрүүлгээс	нидрэх @@үүлэх @@г @@ээс
гэдэснээс	гэдэс @@ээс
хандивт	хандив @@т
захирамжийг	захирах @@мж @@ийг
ирмэгийн	ирмэг @@ийн
цогцолбороор	цогцлох @@бор @@оор
ганцаардалтай	ганцаар @@дах @@л @@тай
автобусыг	автобус @@ыг
цохилттой	цохих @@лт @@той
ариутгах	ариун @@тгах
төстэй	төс @@тэй
хотжилтыг	хот @@жих @@лт @@ыг
уянгад	уянга @@д
түгшүүр	түгших @@үүр
зоодойд	зоодой @@д
ёгтлолыг	ёгт @@лох @@л @@ыг
хайлтын	хайх @@лт @@ын
ертөнцөд	ертөнц @@д
тохуурхлыг	тохуу @@рхах @@л @@ыг
урлалд	урлах @@л @@д
тахаар	тах @@аар
бөхийх	бөх @@ийх
прокурорыг	прокурор @@ыг
шаталтад	шатах @@лт @@д
тэнийх	тэнийх
тоглолтоо	тоглох @@лт @@оо
чих	чих
тараалтаар	тараах @@лт @@аар
мөстэй	мөс @@тэй
хадгалалттай	хадгалах @@лт @@тай
төмрөө	төмөр @@өө
сүсэгтэнд	сүсэг @@тэн @@д
авхуулангаа	авах @@уулан @@аа
соров	соров
төлөгчийг	төлөх @@гч @@ийг
эрхсээ	эрхэс @@ээ
дусалтай	дусах @@л @@тай
борлуулалтад	борлох @@уулах @@лт @@д
заншлаа	занших @@лаа
илээр	ил @@ээр
бялдуучлалын	бялдуу @@члах @@л @@ын
цоолох	цоох @@лох
хувиас	хувь @@ас
бахиудвал	бахь @@уудах @@вал
хучлагын	хучих @@лага @@ын
зүйлийг	зүйл @@ийг
үзэсгэлэнтэй	үзэх @@сгэлэн @@тэй
холгодсоор	холгод @@оос
хийсвэржилт	хийсвэр @@жих @@лт
хэмжигч	хэмжих @@гч
лавлахтай	лав @@лах @@тай
гохноос	гох @@оос
осолд	осол @@д
шүүсэнд	шүүс @@д
урцанд	урц @@д
цалингийн	цалин @@ийн
зөөлрүүлэх	зөөлөрөх @@үүлэх
эргэлзэлд	эргэлзэх @@л @@д
тойргоос	тойрго @@оос
хамтатгалаас	хамт @@тгах @@л @@аас
үерийн	үер @@ийн
баазаа	бааз @@аа
хандивыг	хандив @@ыг
чагт	чагт
үсэглэлд	үсэг @@лэх @@л @@д
товойсон	товойх @@сон
тодорхой	тодорхой
хавчтай	хавч @@тай
ээрүүл	ээрүүл
цочирдмоор	цочир @@дох @@моор
академиа	академи
даруухан	дарах @@уун
зангилаатай	занги @@лах @@аа @@тай
баашаа	бааш @@аа
аних	аних
хулганатай	хулгана @@тай
байшин	байшин
дэрийг	дэр @@ийг
жишгийн	жишиг @@ийн
цахлай	цахлай
байнгатай	байнга @@тай
бодисоос	бодис @@оос
сохирхогч	сохирхох @@гч
командлагчад	команд @@лах @@гч @@д
сандалтай	сандал @@тай
сургуулиа	сургах @@ууль @@а
цалингаас	цалин @@аас
тэмцлээ	тэмцэх @@л @@ээ
шохойгоо	шохой @@оо
уулчинтай	уул @@чин @@тай
шүүмжлэлээ	шүүх @@мж @@лэх @@л @@ээ
зуунаар	зуун @@аар
хөшдөг	хөш @@дөг
ойлголтод	ойлгох @@лт @@д
зүтгэлээс	зүтгэх @@л @@ээс
дарааллыг	дараа @@лах @@л @@ыг
өвлөө	өв @@лөө
хөхөрье	хөх @@рөх @@е
ширэгт	ширэг @@т
модернизмтой	модернизм @@той
төгсөгчийг	төгсөх @@гч @@ийг
хөргөгчөө	хөрөх @@гч @@өө
нэрээр	нэр @@ээр
шүүлтэд	шүүх @@лт @@д
огтлолцлыг	огт @@лох @@лцох @@л @@ыг
дөнжөөс	дөнжөөс
харилцааг	харилцах @@аа @@г
залгах	залгах
компаниар	компани @@ар
шинэтгэлийн	шинэ @@тгэх @@л @@ийн
сүлбэлдээний	сүлбэ @@лдэх @@ээн @@ий
залхууралд	залхуу @@рах @@л @@д
ноёрхлын	ноён @@рхол @@ын
өтнөөс	өт @@өөс
танхимаас	танхим @@аас
таарамжтай	таарах @@мж @@тай
бүжиглэх	бүжиг @@лэх
хөдөлгөөнийг	хөдлөх @@гөх @@өөн @@ийг
жигшил	жигших @@л
хөгөөс	хөг @@өөс
зөгнөлд	зөгнөх @@л @@д
бэртэлт	бэртэх @@лт
шүүмжийн	шүүх @@мж @@ийн
харвалтын	харах @@валт @@ын
талбарыг	талбар @@ыг
өрцний	өрц @@ий
олборлох	олбор @@лох
мөөгний	мөөг @@ий
адрыг	адар @@ыг
үтрээгээ	үтрээ @@ээ
бутаар	бут @@аар
ээрүүлээ	ээрүүл @@ээ
жатгыг	жатга @@ыг
чихтэй	чих @@тэй
тооцоотой	тооцох @@оо @@той
тэнцэтгэлтэй	тэнцэтгэх @@л @@тэй
аялгын	ая @@лга @@ын
сууриа	суурь @@а
устгалаас	устгах @@л @@аас
шавхуур	шавхуу @@р
үйлчлэлийг	үйл @@члэх @@л @@ийг
шинжтэй	шинж @@тэй
зурагчныг	зурах @@гчин @@ыг
зуучлагчид	зууч @@лах @@гч @@д
шоглох	шог @@лох
өнцгийг	өнцөг @@ийг
ваарчин	ваар @@чин
муухай	муухай
шаталтаас	шатах @@лт @@аас
цардасны	цардас @@ы
зугтах	зугтах
тогтворжилтоо	тогтох @@вор @@жих @@лт @@оо
арьсанд	арьс @@д
намтраар	намтар @@аар
керамикаар	керамик @@аар
илтгэлээс	илтгэх @@л @@ээс
дурсамжтай	дурсах @@мж @@тай
хайгуул	хайх @@гуул
сөргөлдөөнтэй	сөрөх @@гөлдөх @@өөн @@тэй
сүйрлээр	сүйрэх @@л @@ээр
тунадсанд	тунах @@дас @@д
зугтлагын	зугтах @@лага @@ын
хасагдагчтай	хасах @@дах @@гч @@тай
гэрлийн	гэрэл @@ийн
мужааныг	мужаан @@ыг
гайхамшгаа	гайхамшиг @@аа
таамгаар	таамг @@аар
оролцоонд	орлох @@цоо @@д
дампуурах	дампуу @@рах
өгөөшнөөс	өгөх @@өөш @@өөс
нийлбэртэй	нийлэр @@тэй
морь	морь
теннисийг	теннис @@ийг
хучилтыг	хучих @@лт @@ыг
графикийг	график @@ийг
сэргээшинд	сэргээ @@шин @@д
найруулгатай	найрах @@уулах @@га @@тай
хэмжээсийг	хэмжих @@ээс @@ийг
дүрслэлтэй	дүрс @@лэх @@л @@тэй
базах	базах
яндангийн	яндан @@ийн
нумнаас	нум @@аас
битүүлгийн	битүүлэх @@г @@ийн
бухимдлаар	бухимдал @@аар
сунгалтыг	сунгах @@лт @@ыг
өвөрлөчих	өвөр @@лөх @@чих
бөглөх	бөглөх
дамжааны	дамжих @@аа @@ы
ялагдлаас	ялах @@гдал @@аас
тариагаар	тариа @@аар
зогсоцтой	зогсох @@ц @@той
дэмжигчийг	дэмжих @@гч @@ийг
өтгөнтэй	өтгөн @@тэй
үйлчлүүлэгчийг	үйл @@члэх @@үүлэх @@гч @@ийг
үйлчилгээг	үйл @@члэх @@гээ
академийн	академ @@ийн
зөрчигчид	зөрчих @@гч @@д
гасланг	гаслан @@г
хуанлиа	хуанлиа
хэлэлцэгчээ	хэлэлцэх @@гч @@ээ
лимбэдэг	лимбэ @@дэг
капиталаас	капитал @@аас
уурхайчнаар	уурхай @@чин @@аар
дархлаагаа	дархлаа @@аа
албажтал	алба @@жих @@л
шүүлтээ	шүүх @@лт @@ээ
гуунд	гуу @@д
тулалдааны	тулах @@лдах @@аан @@ы
эргэлтийн	эргэх @@лт @@ийн
гүйцэд	гүйц @@д
ваарчнаас	ваар @@чин @@аас
оптимизм	оптимизм
символизм	символизм
янхнаас	янх @@аас
солилцох	солилцох
хэрэгжих	хэрэг @@жих
жодоотой	жодоо @@той
батганы	батга @@ы
горьдлогоо	горь @@дох @@лого
үнэлгээний	үнэ @@лэх @@г @@ий
мөргөл	мөргөх @@л
тарах	тарах
экватораар	экватор @@аар
барьцалдаатай	барих @@цах @@лдах @@аай
цуглаанаа	цуг @@лах @@наа
мэрийлтийг	мэрийх @@лт @@ийг
хуурдах	хуурдах
луунаас	луу @@аас
амтгүй	ам @@тгүй
салалтаа	салах @@лт @@аа
тактикийг	тактик @@ийг
тарианы	тариа @@ы
зугаагаар	зугаа @@аар
хоньчноор	хонь @@чин @@ор
хойрго	хойрго
цоожтой	цоож @@той
нөмрөгт	нөмрөг @@т
далайцын	далай @@ц @@ын
редакторын	редактор @@ын
театрыг	театр @@ыг
үрийн	үр @@ийн
оноо	он @@оо
хойгтой	хойг @@той
унжийсан	унж @@ийн @@сан
шоо	шоо
пальтоны	пальто @@ы
баривчилгаагаар	барих @@вч @@лах @@гаа @@ар
далдлалтаар	далдах @@лт @@аар
хурдатгалаа	хурд @@тгах @@л @@аа
сүв	сүв
монополь	монополь
барилгаар	барих @@лга @@аар
дэвэх	дэвэх
гижиг	гижиг
үйлээ	үйл @@ээ
гуйлгад	гуйх @@лга @@д
байлдагчаар	байлдах @@гч @@аар
угжаа	угж @@аа
үсрэлтээс	үсрэх @@лт @@ээс
асуудалтай	асуух @@дал @@тай
өөдсөөр	өөдөс @@өөр
хуулбартай	хуулах @@бар @@тай
санхүүд	сан @@хүү @@д
ялгаагаа	ялгаа @@аа
шингэлтэд	шингэх @@лт @@д
зураасны	зурах @@аас @@ы
үрлэгийг	үрэх @@лэг @@ийг
авхуулшгүй	авах @@уулах @@гүй
нэмэлт	нэмэх @@лт
шаналгаагаа	шаналаг @@аа
идэгдлийн	идэх @@гдэх @@л @@ийн
хондлойтой	хондлой @@той
хорьзно	хорих @@но
шөрмөсөөр	шөрмөс @@өөр
мэдээг	мэд @@ээ @@г
худалдаагаа	худалдах @@аа @@аа
гишүүнтэй	гишүүн @@тэй
тэмдэглэгээнд	тэмдэг @@лэх @@гээ @@д
хоосроосой	хоосоросой
хоног	хоног
амьсгалаар	амь @@сгал @@аар
манлайлал	манлай @@лал
дээврээ	дээвэр @@ээ
цохицгоо	цохих @@цгоо
цомоор	цом @@оор
хөшингөө	хөшин @@өө
даруулыг	дарах @@уул @@ыг
өчигдрийг	өчигдөр @@ийг
хунг	хун @@г
оройгоос	орой @@оос
бачимдлаа	бачим @@дал @@аа
лоозонгоос	лоозон @@оос
дайчинтай	дайн @@чин @@тай
хамгаалагчийн	хамгаалах @@гч @@ийн
мануухай	мануухай
бүрээстэй	бүрээс @@тэй
дамнуурга	дам @@нараг
гүжирдлэгийг	гүжир @@длэг @@ийг
товчийн	товч @@ийн
тэврэлтэд	тэвэр @@х @@лт @@д
ширэнгэд	ширэнгэ @@д
услагчаас	ус @@лах @@гч @@аас
тойргийн	тойрог @@ийн
нимбэгийг	нимбэг @@ийг
маягаас	маяг @@аас
урилгаар	урих @@лга @@аар
хамгаалалтай	хамгаалах @@л @@тай
боолоос	боол @@оос
алганы	алга @@ы
масштабт	масштаб
постоо	пост @@оо
ноорогт	ноорог @@т
жигнэмгээ	жигнэм @@гээ
цавуутай	цавуу @@тай
шохойжингоо	шохой @@жих @@нго
зуун	зуун
манангаар	манан @@аар
баримтлалтай	барих @@мт @@лах @@л @@тай
ганцаардлаас	ганцаар @@дах @@л @@аас
түгжрэлд	түгжих @@рэл @@д
пальтогоо	пальто @@оо
хатуулгаар	хатуулах @@га @@аар
томьёогоор	томьёо @@оор
ходоодтой	ходоод @@той
социализмын	социализм @@ын
агуйнаас	агуй @@аас
теннисний	теннис @@ий
хөрөөдөнгөө	хөрөө @@дөх @@нгөө
түрэмгийллээ	түрэмжий @@лэл @@ээ
доргионы	доргио @@ы
гаригаар	гариг @@аар
соёогоор	соёо @@оор
хэлэхүйг	хэл @@х @@үй @@г
андад	анд @@д
компьютерыг	компьютер @@ыг
хатаагчийг	хатах @@аах @@гч @@ийг
барзайх	барзайх
гацуураас	гацуур @@аас
шугамтай	шугам @@тай
наймаа	найм @@аа
даажигналтай	даажин @@гнах @@л @@тай
олширох	олширох
харшил	харш @@л
хуульд	хууль @@д
судлагчтай	судлах @@гч @@тай
хор	хор
тамаа	там @@аа
өчилтэй	өчих @@л @@тэй
сэдэгчийн	сэдэх @@гч @@ийн
сайдаар	сайд @@аар
хуваагдал	хуваах @@гдах @@л
боломжгүй	боломж @@гүй
урилгатай	урих @@лга @@тай
гулсуураас	гулсах @@уур @@аас
гэмтлийн	гэмтэх @@л @@ийн
хөвгүүнээр	хөвгүүн @@ээр
аэробикийг	аэробик @@ийг
зөрчилд	зөрөх @@чл @@д
хувилбараар	хувилах @@бар @@аар
сархдын	сархад @@ын
хардалтаар	хардах @@лт @@аар
найрлагад	найрах @@лага @@д
зүйлээр	зүйл @@ээр
бизнесийн	бизнес @@ийн
зүрхээр	зүрх @@ээр
бөглөөний	бөглөх @@өө @@ий
маркетингаас	маркетинг @@аас
хөргөө	хөрөг @@өө
шатаах	шатаах
аймшгаа	аймшиг @@аа
сонсчих	сонс @@чих
хойгийн	хойг @@ийн
магтаалтай	магтах @@аал @@тай
суултуурын	суух @@лтуур @@ын
бүлгээр	бүлэг @@ээр
урамшууллаа	урам @@ших @@уулал @@а
бэлгэдэлтэй	бэлгэ @@дэх @@л @@тэй
номлол	ном @@лол
хэлцэлд	хэлцэх @@л @@д
чидунаас	чидун @@аас
мөгөөрсөөр	мөгөр @@өөс
томьёо	томьёо
хэрчдэсэнд	хэрчих @@дэс @@д
хүнийг	хүн @@ийг
дүрвэгчээс	дүрвэх @@гч @@ээс
үүсэлд	үүсэл @@д
баримтаа	барим @@таа
конус	конус
үндэслэлээр	үндэс @@лэх @@л @@ээр
ялгаагүй	ялгаа @@гүй
барьцаанаас	барих @@цаа @@аас
суга	суга
сүсэгтнээс	сүсэг @@тэн @@ээс
барьцалдах	барих @@цах @@лдах
булингартай	булингар @@тай
овоолов	овоо @@лох @@в
төлөөсөнд	төлөх @@өөс @@д
талбайг	талбай @@г
бүтэмж	бүтэх @@мж
үйлтэй	үйл @@тэй
чийдэнгээ	чийдэн @@ээ
тунхаглалд	тунхаг @@лах @@л @@д
үдэшлэгийг	үдэшлэг @@ийг
залгамжлагчийн	залгах @@мж @@лах @@гч @@ийн
гахайтай	гахай @@тай
зөвшилцлийн	зөв @@ших @@лцөх @@л @@ийн
бараан	бараан
доройтох	дорой @@тох
солир	солир
олиг	олиг
чихийг	чих @@ийг
хандивлагчтай	хандив @@лах @@гч @@тай
дугуйгаар	дугуй @@аар
халдлагаа	халдах @@лагаа
тохируулгаас	тохирох @@уулах @@га @@аас
дээрмээ	дээрэм @@ээ
усаар	ус @@аар
хүрмийн	хүрэм @@ийн
халбагаа	халбага @@аа
цогцсын	цогцос @@ын
хямдрах	хямд @@рах
давтамжийг	давтамж @@ийг
түүхийн	түүх @@ийн
цэнэглэгч	цэнэг @@лэх @@гч
илбэчнийг	илбэ @@чин @@ийг
суманд	сум @@д
ачаар	ачих @@аар
хавчаараа	хавч @@аар @@аа
баривч	барих @@вч
томуунаас	томуу @@аас
мэдрэхгүй	мэдрэх @@гүй
цөлийн	цөл @@ийн
чуулга	чуулга
гичийн	гичийн
зөнг	зөн @@г
хотжилтод	хот @@жих @@лт @@д
гогцооны	гогцоо @@ы
нугастай	нугас @@тай
тогтворжилтод	тогтох @@вор @@жих @@лт @@д
бичвэрээ	бичих @@вэр @@ээ
туурайгаа	туурай @@аа
үрээ	үр @@ээ
түгшүүрээр	түгших @@үүр @@ээр
залгамжлагч	залгах @@мж @@лах @@гч
эвээр	эв @@ээр
сургаал	сургах @@аал
жатгатай	жатга @@тай
хашилтад	хаших @@лт @@д
ургамалд	ургах @@мал @@д
солбицсон	солбих @@цосон
мушгирах	мушгирах
сүйтгэгчийн	сүйтгэх @@гч @@ийн
залилангаас	заль @@лан @@аас
шуламтай	шулам @@тай
атомоор	атом @@оор
гирвэштэл	гирвэших @@тэл
талаар	тал @@аар
ташуур	таших @@уур
нуруунаас	нуруу @@аас
хичээнгүй	хичээн @@гүй
морины	морь @@ы
хурлыг	хурал @@ыг
дүрмийг	дүрэм @@ийг
хоолой	хоолой
гахиураас	гахиур @@аас
гүйлтээр	гүйх @@лт @@ээр
моринд	морь @@д
трамвайгаа	трамвай @@аа
цалгих	цалгих
гуйлгачны	гуйх @@лгч @@ы
тайлбар	тайл @@бар
системийг	систем @@ийг
ээрүүлийн	ээрүүл @@ийн
симфонид	симфони @@д
дархлаа	дархл @@аа
тэрэгнээс	тэрэг @@ээс
жуулчны	жуулчин @@ы
сургуультай	сурах @@гах @@ууль @@тай
хавраар	хавар @@аар
төөрөгдөлтэй	төөрөх @@гдөх @@л @@тэй
хангалуун	ханга @@лах @@уун
хүслэнгээр	хүслэн @@ээр
цалинг	цалин @@г
шүүмжлэлд	шүүх @@мж @@лэл @@д
тодорхойлолтын	тод @@рохай @@лох @@лт @@ын
инерцээр	инерц @@ээр
авианы	авиа @@ы
гэрчээр	гэрч @@ээр
шууданчтай	шуудан @@ч @@тай
андгайгаар	андгай @@аар
хулмасыг	хулмас @@ыг
бөгжнөөс	бөгж @@өөс
ургацтай	ургах @@ц @@тай
туршуулаар	турших @@уул @@аар
эгчээр	эгч @@ээр
армиар	арми @@ар
нэмэгдэлтэй	нэмэх @@гдэл @@тэй
оптимизмоо	оптимизм @@оо
нөөцийн	нөөх @@ц @@ийн
шуудан	шуудан
дуулаач	дуу @@лах @@ч
гаригт	гариг @@т
найруулгын	найрах @@уулах @@га @@ын
яс	яс
түгшүүрт	түгших @@үүр @@т
сонгуульд	сон @@гууль @@д
цомоо	цом @@оо
ялгаанд	ялгах @@аа @@д
хохирол	хохирох @@л
дээшлэх	дээш @@лэх
мөрдөсний	мөрдөс @@ий
чичирхийллийн	чичирхий @@лэх @@л @@ийн
гарчгаа	гарчиг @@аа
хавиргатай	хавирга @@тай
бололт	болох @@лт
өвөөгөөр	өвөө @@өөр
засварчнаар	засах @@вар @@чин @@аар
эшлэлээ	эшлэх @@л @@ээ
баазад	бааз @@д
долгиогоор	долгио @@оор
тавилгыг	тавих @@лга @@ыг
мэтгэлцэх	мэтгэлцэх
удамшлыг	удам @@ших @@л @@ыг
шилбэний	шилбэ @@ий
геологиор	геологи @@ор
баяраас	баяр @@аас
зотон	зотон
зөвлөлөөс	зөв @@лөх @@л @@өөс
хүсэх	хүсэх
тэнгэрлэг	тэнгэр @@лэг
сургалтаар	сургах @@лт @@аар
бодролыг	бодорох @@л @@ыг
залиланд	заль @@лан @@д
алтанд	алт @@д
бөглөрөх	бөглөрөх
анчнаа	анчин @@аа
зөвлөх	зөв @@лөх
баримтлалыг	барих @@мтл @@ыг
системтэй	систем @@тэй
төлөх	төлөх
хөргүүр	хөргөх @@үүр
хөхөрсөн	хөх @@рөх @@сөн
хөдөлгүүртэй	хөдөлөх @@гүүр @@тэй
угаалтуурт	угаах @@лтуур @@т
болжмороос	болжмор @@оос
бүргэдээс	бүргэд @@ээс
бахиудсан	бахь @@уус @@д
гимнастикаар	гимнастик @@аар
зодооны	зодоо @@ы
банзлыг	банзал @@ыг
мэдээнд	мэд @@ээ @@д
жатгын	жатга @@ын
цээжний	цээж @@ий
нотолгооноос	нотлох @@гоо @@оос
бүсгүй	бүс @@гүй
цэлийсэн	цэлий @@сэн
ажилчинд	ажил @@лчин @@д
үзүүлэнг	үзэх @@үүлэн @@г
фракцын	фракц @@ын
шивээсэнд	шивэх @@ээс @@д
урагшлангаа	урагш @@лах @@нгаа
бодолтоо	бодох @@лто
тахингаа	тахин @@аа
дуулгаар	дуу @@лах @@гаар
тунадасны	тунах @@дас @@ы
албажвал	алба @@жих @@вал
